0x06442000
0x0000B000
0x00088228
0x06448C84
0x00022200
0x0100B000
0x00088868
0x00188FDA
0x00042200
0x0200B000
0x0008010C
0x00308FA6
0x00322000
0x0300B000
0x0008886C
0x00328FA6
0x00022200
0x0400B000
0x0008889C
0x00188FDA
0x00042200
0x0500B000
0x00080028
0x00308FC0
0x00322000
0x0600B000
0x000888D4
0x00328FC0
